0000000000000000000000000000000
0111111111111111111111111111110
0122222222222222222222222222210
0120000000000000000000000000210
0120000000000000000000000000210
0120000000000000000000000000210
0120000000000000000000000000210
0120000000000000000000000000210
0120000000000000000000000000210
0120000000000000000000000000210
0120000000000000000000000000210
0120000000000000000000000000210
0120000000000000000000000000210
0120000000000000000000000000210
0120000000000000000000000000210
0120000000000000000000000000210
0120000000000000000000000000210
0120000000000000000000000000210
0120000000000000000000000000210
0120000000000000000000000000210
0120000000000000000000000000210
0120000000000000000000000000210
0120000000000000000000000000210
0120000000000000000000000000210
0120000000000000000000000000210
0120000000000000000000000000210
0120000000000000000000000000210
0120000000000000000000000000210
0120000000000000000000000000210
0120000000000000000000000000210
0120000000000000000000000000210
0120000000000000000000000000210
0120000000000000000000000000210
0120000000000000000000000000210
0120000000000000000000000000210
0120000000000000000000000000210
0120000000000000000000000000210
0120000000000000000000000000210
0120000000000000000000000000210
0120000000000000000000000000210
0120000000000000000000000000210
0122222222222222222222222222210
0111111111111111111111111111110
0000000000000000000000000000000


|   *44  -> * 62
v
