0000000000000000000000000000000
0022222222222222222222222222200
0011111111111111111111111111100
0000000000000000000000000000000
0000000000000000000000000000000
0000000000000000000000000000000
0011111111111111111111111111100
0000000000000000000000000000000
0000000000000000000000000000000
0000000000000000000000000000000
0000000000000000000000000000000
0000000000000000000000000000000
0090044444444444444444444400900
0090000000000000000000000000900
0090000000000000000000000000900
0099999999999999999999999999900
0000000000000000000000000000000
0000000000000000000000000000000
0220000000000000000000000000220
0660000000000000000000000000660
0660000000000000000000000000660
0660000000000000000000000000660
0666666666666666666666666666660
0000000000000000000000000000000
0000000000000000000000000000000
0000000000000000000000000000000
0000000000000000000000000000000
0000000000000000000000000000000
0000000000000000000000000000000
0000000000000000000000000000000
0000000000000000000000000000000
0000000000000000000000000000000
0000000000000000000000000000000
0000000000000000000000000000000
0000000000000000000000000000000
0000000000000000000000000000000
0000000000000000000000000000000
0000000000000000000000000000000
0000000000000000000000000000000
0000000000000000000000000000000
0000000000000000000000000000000
0000000000000000000000000000000
0000000000000000000000000000000
0000000000000000000000000000000