0011220011220011220011220011220
0011220011220011220011220011220
0011220011220011220011220011220
0011220011220011220011220011220
0011220011220011220011220011220
0011220011220011220011220011220
0011220011220011220011220011220
0011220011220011220011220011220
0011220011220011220011220011220
0011220011220011220011220011220
0011220011220011220011220011220
0011220011220011220011220011220
0011220011220011220011220011220
0011220011220011220011220011220
0011220011220011220011220011220
0011220011220011220011220011220
0011220011220011220011220011220
0011220011220011220011220011220
0011220011220011220011220011220
0011220011220011220011220011220
0011220011220011220011220011220
0011220011220011220011220011220
0011220011220011220011220011220
0011220011220011220011220011220
0011220011220011220011220011220
0011220011220011220011220011220
0011220011220011220011220011220
0011220011220011220011220011220
0011220011220011220011220011220
0011220011220011220011220011220
0011220011220011220011220011220
0011220011220011220011220011220
0011220011220011220011220011220
0011220011220011220011220011220
0011220011220011220011220011220
0011220011220011220011220011220
0011220011220011220011220011220
0011220011220011220011220011220
0011220011220011220011220011220
0011220011220011220011220011220
0011220011220011220011220011220
0011220011220011220011220011220
0012121212121212121212121212121
0011111111111111111111111111111
0222222222222222222222222222222

|   *44  -> * 31
v
